############################################
#+                $             +      X   #
#    #    #####    ##############          #
#                                          #
#                                          #
#                                          #
#                                          #
#\                         ###########     #
#                                          #
#              $                           #
#                                          #
#         X            O                   #
############################################
