############################################
#                 $                        #
#    #    #####    ##############          #
#                                          #
#                                   X      #
#                    \ ++                  #
#                                          #
#        $             O   ###########     #
#                                          #
#              $                           #
#     X                                    #
#                                          #
############################################
