############################################
#                 $                        #
#    #    #####    ##############          #
#                     X                    #
#         +                                #
#                                          #
#         X                                #
#\       $        +++++  O ###########     #
#                                          #
#              $                           #
#                                          #
# \                                        #
############################################
