############################################
#                 $                    X   #
#    #    #####    ##############          #
#                                          #
#         +                                #
#                                          #
#                                          #
#\       $        +++++  O ###########     #
#                                          #
#              $                           #
#                                          #
# \       X                                #
############################################
