############################################
#+                $             +      X   #
#    #    #####    ##############          #
#                                          #
#                                          #
#                                          #
#                                          #
#\                       O ###########     #
#                                          #
#              $                           #
#                                          #
#         X                                #
############################################
